000000000000000000000000000000000000000000000000000000000000000000000000000000000000000000000000000000000XXXXXXXXXXXXXXXX0000000000000XX0001002003000XX0000000000000X000000000000000000000000000000000000000000000000000000000000000000000000000000000000000000000000000000000000000000000000
000000000000000000000000000000111110030011111111110000011111111000030000111111110000011111111110000011111111110030011111000000000000000222222111222222222222000222222000000000000000000000000000000000000000000000111110030011111111110000011111111000030000111000000000000000000000000000000
000000000000000000000000000000333330000033333333330000033333300000000000003300022222220003300011111110003300022222220003000011111110000000022222220000000011111110000300022222220003300000000000003300000000000003333330000033333333330000033333000000000000000000000000000000000000000000000
000000000000000000000000000000XXXXXXXXXXXXXXXXXXXXXXXXXXXXXX000000000000000000000000000000100000000000001110002020200011111100202001111111111000111111111111000111111111111000111111000000000000000000000000000000000000000000000XXXXX00000XXXXX000000000000000000000000000000000000000000000
boss
000000000000000000000000000000000000000000000000010000010000000101000101000001000111000100001000000000100010022000220010010000000000010010000030000010001000030000100001000030000100000100000001000000010000010000000001000100000000000101000000000000010000000000000000000000000000000000000
000000000000000000000000000000002121212121200002020202020200002020202020200002020202020200002020202020200001111111111100000111111111000000011111110000000001111100000000000111000000000000010000000000000020000000000000020000000001111121111100000000000000000000000000000000000000000000000
000000000000000011111111111110010000000000010010000000000010010000000000010010000000000010011111111111110010000222000010010002000200010010000202000010010000020000010011111111111110010000000000010010000000000010010000000000010011111111111110000000000000000000000000000000000000000000000